00000000000000000000
00000000000000000000
00000000000000000000
00000000000000000000
00000000000000000000
00000000000000000000
00000011111111100000
00000012221222100000
00000012333332100000
00000112323232100000
00000123225222100000
00000123211112110000
00000122144444210000
00000112244444210000
00000011111111110000
00000000000000000000
00000000000000000000
00000000000000000000
00000000000000000000
00000000000000000000